NO ./img/wall2.xpm
SO ./img/wall5.xpm
WE ./img/wall3.xpm
EA ./img/wall4.xpm

F 9,121,32
C 135,206,235

         1111111111111111111111111
         10000000001100001 1111111        
         10110000011100000101111111
         10010000000000000000000001
11111111101100000111000000000000001
10000000000000000111000000000000001
11110111110111010100000010001111111
111101111101110100010100100011
1100000011010101110000001000101
11000E000000000000000000000011
10000000001010001101010010001
110000011101010111110111100011
11110111 1110101 1011110100011
11111111 1111111 111111111111